,Country,Years,Gold,Silver,Bronze,Total
0,United States,1896,11,7,2,20
1,Greece,1896,10,18,19,47
2,Germany,1896,6,5,2,13
3,France,1896,5,4,2,11
4,Great Britain,1896,2,3,2,7
5,Hungary,1896,2,1,3,6
6,Austria,1896,2,1,2,5
7,Australia,1896,2,0,0,2
8,Denmark,1896,1,2,3,6
9,Switzerland,1896,1,2,0,3
10,Mixed team,1896,1,0,1,2
11,France,1900,27,39,37,103
12,United States,1900,19,14,15,48
13,Great Britain,1900,15,7,9,31
14,Mixed team,1900,8,5,6,19
15,Belgium,1900,6,7,4,17
16,Switzerland,1900,6,2,1,9
17,Germany,1900,4,3,2,9
18,Italy,1900,3,2,0,5
19,Australia,1900,2,0,3,5
20,Denmark,1900,1,3,2,6
21,Hungary,1900,1,2,2,5
22,Cuba,1900,1,1,0,2
23,Canada,1900,1,0,1,2
24,Spain,1900,1,0,0,1
25,Luxembourg,1900,1,0,0,1
26,Austria,1900,0,3,3,6
27,Norway,1900,0,2,3,5
28,Netherlands,1900,0,2,3,5
29,India,1900,0,2,0,2
30,Bohemia,1900,0,1,1,2
31,Sweden,1900,0,0,1,1
32,United States,1904,76,78,77,231
33,Germany,1904,4,5,6,15
34,Canada,1904,4,1,1,6
35,Cuba,1904,3,0,0,3
36,Hungary,1904,2,1,1,4
37,Mixed team,1904,2,1,1,4
38,Norway,1904,2,0,0,2
39,Austria,1904,1,1,1,3
40,Great Britain,1904,1,1,0,2
41,Switzerland,1904,1,0,2,3
42,Greece,1904,1,0,1,2
43,Australia,1904,0,3,1,4
44,France,1904,0,1,0,1
45,Great Britain,1908,56,51,39,146
46,United States,1908,23,12,12,47
47,Sweden,1908,8,6,11,25
48,France,1908,5,5,9,19
49,Germany,1908,3,5,5,13
50,Hungary,1908,3,4,2,9
51,Canada,1908,3,3,10,16
52,Norway,1908,2,3,3,8
53,Italy,1908,2,2,0,4
54,Belgium,1908,1,5,2,8
55,Australasia,1908,1,2,2,5
56,Russian Empire,1908,1,2,0,3
57,Finland,1908,1,1,3,5
58,South Africa,1908,1,1,0,2
59,Greece,1908,0,3,1,4
60,Denmark,1908,0,2,3,5
61,Bohemia,1908,0,0,2,2
62,Netherlands,1908,0,0,2,2
63,Austria,1908,0,0,1,1
64,United States,1912,26,19,19,64
65,Sweden,1912,23,25,17,65
66,Great Britain,1912,10,15,16,41
67,Finland,1912,9,8,9,26
68,France,1912,7,4,3,14
69,Germany,1912,5,13,7,25
70,South Africa,1912,4,2,0,6
71,Norway,1912,3,2,5,10
72,Canada,1912,3,2,3,8
73,Hungary,1912,3,2,3,8
74,Italy,1912,3,1,2,6
75,Australasia,1912,2,2,3,7
76,Belgium,1912,2,1,3,6
77,Denmark,1912,1,6,5,12
78,Greece,1912,1,0,1,2
79,Russian Empire,1912,0,2,3,5
80,Austria,1912,0,2,2,4
81,Netherlands,1912,0,0,3,3
82,United States,1920,41,27,27,95
83,Sweden,1920,19,20,25,64
84,Finland,1920,15,10,9,34
85,Great Britain,1920,14,15,13,42
86,Belgium,1920,14,11,11,36
87,Norway,1920,13,9,9,31
88,Italy,1920,13,5,5,23
89,France,1920,9,19,13,41
90,Netherlands,1920,4,2,5,11
91,Denmark,1920,3,9,1,13
92,South Africa,1920,3,4,3,10
93,Canada,1920,3,3,3,9
94,Switzerland,1920,2,2,7,11
95,Estonia,1920,1,2,0,3
96,Brazil,1920,1,1,1,3
97,Australia,1920,0,2,1,3
98,Japan,1920,0,2,0,2
99,Spain,1920,0,2,0,2
100,Greece,1920,0,1,0,1
101,Luxembourg,1920,0,1,0,1
102,Czechoslovakia,1920,0,0,2,2
103,New Zealand,1920,0,0,1,1
104,United States,1924,45,27,27,99
105,Finland,1924,14,13,10,37
106,France,1924,13,15,10,38
107,Great Britain,1924,9,13,12,34
108,Italy,1924,8,3,5,16
109,Switzerland,1924,7,8,10,25
110,Norway,1924,5,2,3,10
111,Sweden,1924,4,13,12,29
112,Netherlands,1924,4,1,5,10
113,Belgium,1924,3,7,3,13
114,Australia,1924,3,1,2,6
115,Denmark,1924,2,5,2,9
116,Hungary,1924,2,3,4,9
117,Yugoslavia,1924,2,0,0,2
118,Czechoslovakia,1924,1,4,5,10
119,Argentina,1924,1,3,2,6
120,Estonia,1924,1,1,4,6
121,South Africa,1924,1,1,1,3
122,Uruguay,1924,1,0,0,1
123,Austria,1924,0,3,1,4
124,Canada,1924,0,3,1,4
125,Poland,1924,0,1,1,2
126,Haiti,1924,0,0,1,1
127,Japan,1924,0,0,1,1
128,New Zealand,1924,0,0,1,1
129,Portugal,1924,0,0,1,1
130,Romania,1924,0,0,1,1
131,United States,1928,22,18,16,56
132,Germany,1928,10,7,14,31
133,Finland,1928,8,8,9,25
134,Sweden,1928,7,6,12,25
135,Italy,1928,7,5,7,19
136,Switzerland,1928,7,4,4,15
137,France,1928,6,10,5,21
138,Netherlands,1928,6,9,4,19
139,Hungary,1928,4,5,0,9
140,Canada,1928,4,4,7,15
141,Great Britain,1928,3,10,7,20
142,Argentina,1928,3,3,1,7
143,Denmark,1928,3,1,2,6
144,Czechoslovakia,1928,2,5,2,9
145,Japan,1928,2,2,1,5
146,Estonia,1928,2,1,2,5
147,Egypt,1928,2,1,1,4
148,Austria,1928,2,0,1,3
149,Australia,1928,1,2,1,4
150,Norway,1928,1,2,1,4
151,Poland,1928,1,1,3,5
152,Yugoslavia,1928,1,1,3,5
153,South Africa,1928,1,0,2,3
154,India,1928,1,0,0,1
155,Ireland,1928,1,0,0,1
156,New Zealand,1928,1,0,0,1
157,Spain,1928,1,0,0,1
158,Uruguay,1928,1,0,0,1
159,Belgium,1928,0,1,2,3
160,Chile,1928,0,1,0,1
161,Haiti,1928,0,1,0,1
162,Philippines,1928,0,0,1,1
163,Portugal,1928,0,0,1,1
164,United States,1932,44,36,30,110
165,Italy,1932,12,12,12,36
166,France,1932,11,5,4,20
167,Sweden,1932,10,5,9,24
168,Japan,1932,7,7,4,18
169,Hungary,1932,6,5,5,16
170,Germany,1932,5,12,7,24
171,Finland,1932,5,8,12,25
172,Great Britain,1932,5,7,5,17
173,Poland,1932,3,2,4,9
174,Australia,1932,3,1,1,5
175,Argentina,1932,3,1,0,4
176,Canada,1932,2,5,9,16
177,Netherlands,1932,2,5,1,8
178,South Africa,1932,2,0,3,5
179,Ireland,1932,2,0,0,2
180,Czechoslovakia,1932,1,3,2,6
181,Austria,1932,1,1,3,5
182,India,1932,1,0,0,1
183,Denmark,1932,0,5,3,8
184,Mexico,1932,0,2,0,2
185,Latvia,1932,0,1,0,1
186,New Zealand,1932,0,1,0,1
187,Switzerland,1932,0,1,0,1
188,Philippines,1932,0,0,3,3
189,Belgium,1932,0,0,1,1
190,Spain,1932,0,0,1,1
191,Uruguay,1932,0,0,1,1
192,Germany,1936,38,31,32,101
193,United States,1936,24,21,12,57
194,Hungary,1936,10,1,5,16
195,Italy,1936,9,13,5,27
196,Finland,1936,8,6,6,20
197,France,1936,7,6,6,19
198,Sweden,1936,6,5,10,21
199,Japan,1936,6,4,10,20
200,Netherlands,1936,6,4,7,17
201,Austria,1936,5,7,5,17
202,Switzerland,1936,4,9,5,18
203,Great Britain,1936,4,7,3,14
204,Czechoslovakia,1936,3,5,1,9
205,Argentina,1936,2,2,3,7
206,Estonia,1936,2,2,3,7
207,Egypt,1936,2,1,2,5
208,Canada,1936,1,3,5,9
209,Norway,1936,1,3,2,6
210,Turkey,1936,1,0,1,2
211,India,1936,1,0,0,1
212,New Zealand,1936,1,0,0,1
213,Poland,1936,0,4,5,9
214,Denmark,1936,0,2,3,5
215,Latvia,1936,0,1,1,2
216,Romania,1936,0,1,0,1
217,South Africa,1936,0,1,0,1
218,Yugoslavia,1936,0,1,0,1
219,Belgium,1936,0,0,3,3
220,Mexico,1936,0,0,3,3
221,Australia,1936,0,0,1,1
222,Philippines,1936,0,0,1,1
223,Portugal,1936,0,0,1,1
224,United States,1948,38,27,19,84
225,Sweden,1948,16,11,17,44
226,France,1948,10,6,13,29
227,Hungary,1948,10,5,12,27
228,Italy,1948,8,11,8,27
229,Finland,1948,8,7,5,20
230,Turkey,1948,6,4,2,12
231,Czechoslovakia,1948,6,2,3,11
232,Switzerland,1948,5,10,5,20
233,Denmark,1948,5,7,8,20
234,Netherlands,1948,5,2,9,16
235,Great Britain,1948,3,14,6,23
236,Argentina,1948,3,3,1,7
237,Australia,1948,2,6,5,13
238,Belgium,1948,2,2,3,7
239,Egypt,1948,2,2,1,5
240,Mexico,1948,2,1,2,5
241,South Africa,1948,2,1,1,4
242,Norway,1948,1,3,3,7
243,Jamaica,1948,1,2,0,3
244,Austria,1948,1,0,3,4
245,India,1948,1,0,0,1
246,Peru,1948,1,0,0,1
247,Yugoslavia,1948,0,2,0,2
248,Canada,1948,0,1,2,3
249,Portugal,1948,0,1,1,2
250,Uruguay,1948,0,1,1,2
251,Ceylon,1948,0,1,0,1
252,Cuba,1948,0,1,0,1
253,Spain,1948,0,1,0,1
254,Trinidad and Tobago,1948,0,1,0,1
255,Panama,1948,0,0,2,2
256,South Korea,1948,0,0,2,2
257,Brazil,1948,0,0,1,1
258,Iran,1948,0,0,1,1
259,Poland,1948,0,0,1,1
260,Puerto Rico,1948,0,0,1,1
261,United States,1952,40,19,17,76
262,Soviet Union,1952,22,30,19,71
263,Hungary,1952,16,10,16,42
264,Sweden,1952,12,13,10,35
265,Italy,1952,8,9,4,21
266,Czechoslovakia,1952,7,3,3,13
267,France,1952,6,6,6,18
268,Finland,1952,6,3,13,22
269,Australia,1952,6,2,3,11
270,Norway,1952,3,2,0,5
271,Switzerland,1952,2,6,6,14
272,South Africa,1952,2,4,4,10
273,Jamaica,1952,2,3,0,5
274,Belgium,1952,2,2,0,4
275,Denmark,1952,2,1,3,6
276,Turkey,1952,2,0,1,3
277,Japan,1952,1,6,2,9
278,Great Britain,1952,1,2,8,11
279,Argentina,1952,1,2,2,5
280,Poland,1952,1,2,1,4
281,Canada,1952,1,2,0,3
282,Yugoslavia,1952,1,2,0,3
283,Romania,1952,1,1,2,4
284,Brazil,1952,1,0,2,3
285,New Zealand,1952,1,0,2,3
286,India,1952,1,0,1,2
287,Luxembourg,1952,1,0,0,1
288,Germany,1952,0,7,17,24
289,Netherlands,1952,0,5,0,5
290,Iran,1952,0,3,4,7
291,Chile,1952,0,2,0,2
292,Austria,1952,0,1,1,2
293,Lebanon,1952,0,1,1,2
294,Ireland,1952,0,1,0,1
295,Mexico,1952,0,1,0,1
296,Spain,1952,0,1,0,1
297,South Korea,1952,0,0,2,2
298,Trinidad and Tobago,1952,0,0,2,2
299,Uruguay,1952,0,0,2,2
300,Bulgaria,1952,0,0,1,1
301,Egypt,1952,0,0,1,1
302,Portugal,1952,0,0,1,1
303,Venezuela,1952,0,0,1,1
304,Soviet Union,1956,37,29,32,98
305,United States,1956,32,25,17,74
306,Australia,1956,13,8,14,35
307,Hungary,1956,9,10,7,26
308,Italy,1956,8,8,9,25
309,Sweden,1956,8,5,6,19
310,United Team of Germany,1956,6,13,7,26
311,Great Britain,1956,6,7,11,24
312,Romania,1956,5,3,5,13
313,Japan,1956,4,10,5,19
314,France,1956,4,4,6,14
315,Turkey,1956,3,2,2,7
316,Finland,1956,3,1,11,15
317,Iran,1956,2,2,1,5
318,Canada,1956,2,1,3,6
319,New Zealand,1956,2,0,0,2
320,Poland,1956,1,4,4,9
321,Czechoslovakia,1956,1,4,1,6
322,Bulgaria,1956,1,3,1,5
323,Denmark,1956,1,2,1,4
324,Ireland,1956,1,1,3,5
325,Norway,1956,1,0,2,3
326,Mexico,1956,1,0,1,2
327,Brazil,1956,1,0,0,1
328,India,1956,1,0,0,1
329,Yugoslavia,1956,0,3,0,3
330,Chile,1956,0,2,2,4
331,Belgium,1956,0,2,0,2
332,Argentina,1956,0,1,1,2
333,South Korea,1956,0,1,1,2
334,Iceland,1956,0,1,0,1
335,Pakistan,1956,0,1,0,1
336,South Africa,1956,0,0,4,4
337,Austria,1956,0,0,2,2
338,Bahamas,1956,0,0,1,1
339,Greece,1956,0,0,1,1
340,Switzerland,1956,0,0,1,1
341,Uruguay,1956,0,0,1,1
342,Soviet Union,1960,43,29,31,103
343,United States,1960,34,21,16,71
344,Italy,1960,13,10,13,36
345,United Team of Germany,1960,12,19,11,42
346,Australia,1960,8,8,6,22
347,Turkey,1960,7,2,0,9
348,Hungary,1960,6,8,7,21
349,Japan,1960,4,7,7,18
350,Poland,1960,4,6,11,21
351,Czechoslovakia,1960,3,2,3,8
352,Romania,1960,3,1,6,10
353,Great Britain,1960,2,6,12,20
354,Denmark,1960,2,3,1,6
355,New Zealand,1960,2,0,1,3
356,Bulgaria,1960,1,3,3,7
357,Sweden,1960,1,2,3,6
358,Finland,1960,1,1,3,5
359,Austria,1960,1,1,0,2
360,Yugoslavia,1960,1,1,0,2
361,Pakistan,1960,1,0,1,2
362,Ethiopia,1960,1,0,0,1
363,Greece,1960,1,0,0,1
364,Norway,1960,1,0,0,1
365,Switzerland,1960,0,3,3,6
366,France,1960,0,2,3,5
367,Belgium,1960,0,2,2,4
368,Iran,1960,0,1,3,4
369,Netherlands,1960,0,1,2,3
370,South Africa,1960,0,1,2,3
371,Argentina,1960,0,1,1,2
372,Egypt,1960,0,1,1,2
373,Canada,1960,0,1,0,1
374,Formosa,1960,0,1,0,1
375,Ghana,1960,0,1,0,1
376,India,1960,0,1,0,1
377,Morocco,1960,0,1,0,1
378,Portugal,1960,0,1,0,1
379,Singapore,1960,0,1,0,1
380,Brazil,1960,0,0,2,2
381,British West Indies,1960,0,0,2,2
382,Iraq,1960,0,0,1,1
383,Mexico,1960,0,0,1,1
384,Spain,1960,0,0,1,1
385,Venezuela,1960,0,0,1,1
386,United States,1964,36,26,28,90
387,Soviet Union,1964,30,31,35,96
388,Japan,1964,16,5,8,29
389,United Team of Germany,1964,10,22,18,50
390,Italy,1964,10,10,7,27
391,Hungary,1964,10,7,5,22
392,Poland,1964,7,6,10,23
393,Australia,1964,6,2,10,18
394,Czechoslovakia,1964,5,6,3,14
395,Great Britain,1964,4,12,2,18
396,Bulgaria,1964,3,5,2,10
397,Finland,1964,3,0,2,5
398,New Zealand,1964,3,0,2,5
399,Romania,1964,2,4,6,12
400,Netherlands,1964,2,4,4,10
401,Turkey,1964,2,3,1,6
402,Sweden,1964,2,2,4,8
403,Denmark,1964,2,1,3,6
404,Yugoslavia,1964,2,1,2,5
405,Belgium,1964,2,0,1,3
406,France,1964,1,8,6,15
407,Canada,1964,1,2,1,4
408,Switzerland,1964,1,2,1,4
409,Bahamas,1964,1,0,0,1
410,Ethiopia,1964,1,0,0,1
411,India,1964,1,0,0,1
412,South Korea,1964,0,2,1,3
413,Trinidad and Tobago,1964,0,1,2,3
414,Tunisia,1964,0,1,1,2
415,Argentina,1964,0,1,0,1
416,Cuba,1964,0,1,0,1
417,Pakistan,1964,0,1,0,1
418,Philippines,1964,0,1,0,1
419,Iran,1964,0,0,2,2
420,Brazil,1964,0,0,1,1
421,Ghana,1964,0,0,1,1
422,Ireland,1964,0,0,1,1
423,Kenya,1964,0,0,1,1
424,Mexico,1964,0,0,1,1
425,Nigeria,1964,0,0,1,1
426,Uruguay,1964,0,0,1,1
427,United States,1968,45,28,34,107
428,Soviet Union,1968,29,32,30,91
429,Japan,1968,11,7,7,25
430,Hungary,1968,10,10,12,32
431,East Germany,1968,9,9,7,25
432,France,1968,7,3,5,15
433,Czechoslovakia,1968,7,2,4,13
434,West Germany,1968,5,11,10,26
435,Australia,1968,5,7,5,17
436,Great Britain,1968,5,5,3,13
437,Poland,1968,5,2,11,18
438,Romania,1968,4,6,5,15
439,Italy,1968,3,4,9,16
440,Kenya,1968,3,4,2,9
441,Mexico,1968,3,3,3,9
442,Yugoslavia,1968,3,3,2,8
443,Netherlands,1968,3,3,1,7
444,Bulgaria,1968,2,4,3,9
445,Iran,1968,2,1,2,5
446,Sweden,1968,2,1,1,4
447,Turkey,1968,2,0,0,2
448,Denmark,1968,1,4,3,8
449,Canada,1968,1,3,1,5
450,Finland,1968,1,2,1,4
451,Ethiopia,1968,1,1,0,2
452,Norway,1968,1,1,0,2
453,New Zealand,1968,1,0,2,3
454,Tunisia,1968,1,0,1,2
455,Pakistan,1968,1,0,0,1
456,Venezuela,1968,1,0,0,1
457,Cuba,1968,0,4,0,4
458,Austria,1968,0,2,2,4
459,Switzerland,1968,0,1,4,5
460,Mongolia,1968,0,1,3,4
461,Brazil,1968,0,1,2,3
462,Belgium,1968,0,1,1,2
463,South Korea,1968,0,1,1,2
464,Uganda,1968,0,1,1,2
465,Cameroon,1968,0,1,0,1
466,Jamaica,1968,0,1,0,1
467,Argentina,1968,0,0,2,2
468,Greece,1968,0,0,1,1
469,India,1968,0,0,1,1
470,Taiwan,1968,0,0,1,1
471,Soviet Union,1972,50,27,22,99
472,United States,1972,33,31,30,94
473,East Germany,1972,20,23,23,66
474,West Germany,1972,13,11,16,40
475,Japan,1972,13,8,8,29
476,Australia,1972,8,7,2,17
477,Poland,1972,7,5,9,21
478,Hungary,1972,6,13,16,35
479,Bulgaria,1972,6,10,5,21
480,Italy,1972,5,3,10,18
481,Sweden,1972,4,6,6,16
482,Great Britain,1972,4,5,9,18
483,Romania,1972,3,6,7,16
484,Cuba,1972,3,1,4,8
485,Finland,1972,3,1,4,8
486,Netherlands,1972,3,1,1,5
487,France,1972,2,4,7,13
488,Czechoslovakia,1972,2,4,2,8
489,Kenya,1972,2,3,4,9
490,Yugoslavia,1972,2,1,2,5
491,Norway,1972,2,1,1,4
492,North Korea,1972,1,1,3,5
493,New Zealand,1972,1,1,1,3
494,Uganda,1972,1,1,0,2
495,Denmark,1972,1,0,0,1
496,Switzerland,1972,0,3,0,3
497,Canada,1972,0,2,3,5
498,Iran,1972,0,2,1,3
499,Belgium,1972,0,2,0,2
500,Greece,1972,0,2,0,2
501,Austria,1972,0,1,2,3
502,Colombia,1972,0,1,2,3
503,Argentina,1972,0,1,0,1
504,Lebanon,1972,0,1,0,1
505,Mexico,1972,0,1,0,1
506,Mongolia,1972,0,1,0,1
507,Pakistan,1972,0,1,0,1
508,South Korea,1972,0,1,0,1
509,Tunisia,1972,0,1,0,1
510,Turkey,1972,0,1,0,1
511,Brazil,1972,0,0,2,2
512,Ethiopia,1972,0,0,2,2
513,Ghana,1972,0,0,1,1
514,India,1972,0,0,1,1
515,Jamaica,1972,0,0,1,1
516,Niger,1972,0,0,1,1
517,Nigeria,1972,0,0,1,1
518,Spain,1972,0,0,1,1
519,Soviet Union,1976,49,41,35,125
520,East Germany,1976,40,25,25,90
521,United States,1976,34,35,25,94
522,West Germany,1976,10,12,17,39
523,Japan,1976,9,6,10,25
524,Poland,1976,7,6,13,26
525,Bulgaria,1976,6,9,7,22
526,Cuba,1976,6,4,3,13
527,Romania,1976,4,9,14,27
528,Hungary,1976,4,5,13,22
529,Finland,1976,4,2,0,6
530,Sweden,1976,4,1,0,5
531,Great Britain,1976,3,5,5,13
532,Italy,1976,2,7,4,13
533,France,1976,2,3,4,9
534,Yugoslavia,1976,2,3,3,8
535,Czechoslovakia,1976,2,2,4,8
536,New Zealand,1976,2,1,1,4
537,South Korea,1976,1,1,4,6
538,Switzerland,1976,1,1,2,4
539,Jamaica,1976,1,1,0,2
540,North Korea,1976,1,1,0,2
541,Norway,1976,1,1,0,2
542,Denmark,1976,1,0,2,3
543,Mexico,1976,1,0,1,2
544,Trinidad and Tobago,1976,1,0,0,1
545,Canada,1976,0,5,6,11
546,Belgium,1976,0,3,3,6
547,Netherlands,1976,0,2,3,5
548,Portugal,1976,0,2,0,2
549,Spain,1976,0,2,0,2
550,Australia,1976,0,1,4,5
551,Iran,1976,0,1,1,2
552,Mongolia,1976,0,1,0,1
553,Venezuela,1976,0,1,0,1
554,Brazil,1976,0,0,2,2
555,Austria,1976,0,0,1,1
556,Bermuda,1976,0,0,1,1
557,Pakistan,1976,0,0,1,1
558,Puerto Rico,1976,0,0,1,1
559,Thailand,1976,0,0,1,1
560,Soviet Union,1980,80,69,46,195
561,East Germany,1980,47,37,42,126
562,Bulgaria,1980,8,16,17,41
563,Cuba,1980,8,7,5,20
564,Italy,1980,8,3,4,15
565,Hungary,1980,7,10,15,32
566,Romania,1980,6,6,13,25
567,France,1980,6,5,3,14
568,Great Britain,1980,5,7,9,21
569,Poland,1980,3,14,15,32
570,Sweden,1980,3,3,6,12
571,Finland,1980,3,1,4,8
572,Czechoslovakia,1980,2,3,9,14
573,Yugoslavia,1980,2,3,4,9
574,Australia,1980,2,2,5,9
575,Denmark,1980,2,1,2,5
576,Brazil,1980,2,0,2,4
577,Ethiopia,1980,2,0,2,4
578,Switzerland,1980,2,0,0,2
579,Spain,1980,1,3,2,6
580,Austria,1980,1,2,1,4
581,Greece,1980,1,0,2,3
582,Belgium,1980,1,0,0,1
583,India,1980,1,0,0,1
584,Zimbabwe,1980,1,0,0,1
585,North Korea,1980,0,3,2,5
586,Mongolia,1980,0,2,2,4
587,Tanzania,1980,0,2,0,2
588,Mexico,1980,0,1,3,4
589,Netherlands,1980,0,1,2,3
590,Ireland,1980,0,1,1,2
591,Uganda,1980,0,1,0,1
592,Venezuela,1980,0,1,0,1
593,Jamaica,1980,0,0,3,3
594,Guyana,1980,0,0,1,1
595,Lebanon,1980,0,0,1,1
596,United States,1984,83,61,30,174
597,Romania,1984,20,16,17,53
598,West Germany,1984,17,19,23,59
599,China,1984,15,8,9,32
600,Italy,1984,14,6,12,32
601,Canada,1984,10,18,16,44
602,Japan,1984,10,8,14,32
603,New Zealand,1984,8,1,2,11
604,Yugoslavia,1984,7,4,7,18
605,South Korea,1984,6,6,7,19
606,Great Britain,1984,5,11,21,37
607,France,1984,5,7,16,28
608,Netherlands,1984,5,2,6,13
609,Australia,1984,4,8,12,24
610,Finland,1984,4,2,6,12
611,Sweden,1984,2,11,6,19
612,Mexico,1984,2,3,1,6
613,Morocco,1984,2,0,0,2
614,Brazil,1984,1,5,2,8
615,Spain,1984,1,2,2,5
616,Belgium,1984,1,1,2,4
617,Austria,1984,1,1,1,3
618,Kenya,1984,1,0,2,3
619,Portugal,1984,1,0,2,3
620,Pakistan,1984,1,0,0,1
621,Switzerland,1984,0,4,4,8
622,Denmark,1984,0,3,3,6
623,Jamaica,1984,0,1,2,3
624,Norway,1984,0,1,2,3
625,Greece,1984,0,1,1,2
626,Nigeria,1984,0,1,1,2
627,Puerto Rico,1984,0,1,1,2
628,Colombia,1984,0,1,0,1
629,Egypt,1984,0,1,0,1
630,Ireland,1984,0,1,0,1
631,Ivory Coast,1984,0,1,0,1
632,Peru,1984,0,1,0,1
633,Syria,1984,0,1,0,1
634,Thailand,1984,0,1,0,1
635,Turkey,1984,0,0,3,3
636,Venezuela,1984,0,0,3,3
637,Algeria,1984,0,0,2,2
638,Cameroon,1984,0,0,1,1
639,Chinese Taipei,1984,0,0,1,1
640,Dominican Republic,1984,0,0,1,1
641,Iceland,1984,0,0,1,1
642,Zambia,1984,0,0,1,1
643,Soviet Union,1988,55,31,46,132
644,East Germany,1988,37,35,30,102
645,United States,1988,36,31,27,94
646,South Korea,1988,12,10,11,33
647,West Germany,1988,11,14,15,40
648,Hungary,1988,11,6,6,23
649,Bulgaria,1988,10,12,13,35
650,Romania,1988,7,11,6,24
651,France,1988,6,4,6,16
652,Italy,1988,6,4,4,14
653,China,1988,5,11,12,28
654,Great Britain,1988,5,10,9,24
655,Kenya,1988,5,2,2,9
656,Japan,1988,4,3,7,14
657,Australia,1988,3,6,5,14
658,Yugoslavia,1988,3,4,5,12
659,Czechoslovakia,1988,3,3,2,8
660,New Zealand,1988,3,2,8,13
661,Canada,1988,3,2,5,10
662,Poland,1988,2,5,9,16
663,Norway,1988,2,3,0,5
664,Netherlands,1988,2,2,5,9
665,Denmark,1988,2,1,1,4
666,Brazil,1988,1,2,3,6
667,Finland,1988,1,1,2,4
668,Spain,1988,1,1,2,4
669,Turkey,1988,1,1,0,2
670,Morocco,1988,1,0,2,3
671,Austria,1988,1,0,0,1
672,Portugal,1988,1,0,0,1
673,Suriname,1988,1,0,0,1
674,Sweden,1988,0,4,7,11
675,Switzerland,1988,0,2,2,4
676,Jamaica,1988,0,2,0,2
677,Argentina,1988,0,1,1,2
678,Chile,1988,0,1,0,1
679,Costa Rica,1988,0,1,0,1
680,Indonesia,1988,0,1,0,1
681,Iran,1988,0,1,0,1
682,Netherlands Antilles,1988,0,1,0,1
683,Peru,1988,0,1,0,1
684,Senegal,1988,0,1,0,1
685,Virgin Islands,1988,0,1,0,1
686,Belgium,1988,0,0,2,2
687,Mexico,1988,0,0,2,2
688,Colombia,1988,0,0,1,1
689,Djibouti,1988,0,0,1,1
690,Greece,1988,0,0,1,1
691,Mongolia,1988,0,0,1,1
692,Pakistan,1988,0,0,1,1
693,Philippines,1988,0,0,1,1
694,Thailand,1988,0,0,1,1
695,Unified Team,1992,45,38,29,112
696,United States,1992,37,34,37,108
697,Germany,1992,33,21,28,82
698,China,1992,16,22,16,54
699,Cuba,1992,14,6,11,31
700,Spain,1992,13,7,2,22
701,South Korea,1992,12,5,12,29
702,Hungary,1992,11,12,7,30
703,France,1992,8,5,16,29
704,Australia,1992,7,9,11,27
705,Canada,1992,7,4,7,18
706,Italy,1992,6,5,8,19
707,Great Britain,1992,5,3,12,20
708,Romania,1992,4,6,8,18
709,Czechoslovakia,1992,4,2,1,7
710,North Korea,1992,4,0,5,9
711,Japan,1992,3,8,11,22
712,Bulgaria,1992,3,7,6,16
713,Poland,1992,3,6,10,19
714,Netherlands,1992,2,6,7,15
715,Kenya,1992,2,4,2,8
716,Norway,1992,2,4,1,7
717,Turkey,1992,2,2,2,6
718,Indonesia,1992,2,2,1,5
719,Brazil,1992,2,1,0,3
720,Greece,1992,2,0,0,2
721,Sweden,1992,1,7,4,12
722,New Zealand,1992,1,4,5,10
723,Finland,1992,1,2,2,5
724,Denmark,1992,1,1,4,6
725,Morocco,1992,1,1,1,3
726,Ireland,1992,1,1,0,2
727,Ethiopia,1992,1,0,2,3
728,Algeria,1992,1,0,1,2
729,Estonia,1992,1,0,1,2
730,Lithuania,1992,1,0,1,2
731,Switzerland,1992,1,0,0,1
732,Jamaica,1992,0,3,1,4
733,Nigeria,1992,0,3,1,4
734,Latvia,1992,0,2,1,3
735,Austria,1992,0,2,0,2
736,Namibia,1992,0,2,0,2
737,South Africa,1992,0,2,0,2
738,Belgium,1992,0,1,2,3
739,Croatia,1992,0,1,2,3
740,Independent Olympic Participants,1992,0,1,2,3
741,Iran,1992,0,1,2,3
742,Israel,1992,0,1,1,2
743,Chinese Taipei,1992,0,1,0,1
744,Mexico,1992,0,1,0,1
745,Peru,1992,0,1,0,1
746,Mongolia,1992,0,0,2,2
747,Slovenia,1992,0,0,2,2
748,Argentina,1992,0,0,1,1
749,Bahamas,1992,0,0,1,1
750,Colombia,1992,0,0,1,1
751,Ghana,1992,0,0,1,1
752,Malaysia,1992,0,0,1,1
753,Pakistan,1992,0,0,1,1
754,Philippines,1992,0,0,1,1
755,Puerto Rico,1992,0,0,1,1
756,Qatar,1992,0,0,1,1
757,Suriname,1992,0,0,1,1
758,Thailand,1992,0,0,1,1
759,United States,1996,44,32,25,101
760,Russia,1996,26,21,16,63
761,Germany,1996,20,18,27,65
762,China,1996,16,22,12,50
763,France,1996,15,7,15,37
764,Italy,1996,13,10,12,35
765,Australia,1996,9,9,23,41
766,Cuba,1996,9,8,8,25
767,Ukraine,1996,9,2,12,23
768,South Korea,1996,7,15,5,27
769,Poland,1996,7,5,5,17
770,Hungary,1996,7,4,10,21
771,Spain,1996,5,6,6,17
772,Romania,1996,4,7,9,20
773,Netherlands,1996,4,5,10,19
774,Greece,1996,4,4,0,8
775,Czech Republic,1996,4,3,4,11
776,Switzerland,1996,4,3,0,7
777,Denmark,1996,4,1,1,6
778,Turkey,1996,4,1,1,6
779,Canada,1996,3,11,8,22
780,Bulgaria,1996,3,7,5,15
781,Japan,1996,3,6,5,14
782,Kazakhstan,1996,3,4,4,11
783,Brazil,1996,3,3,9,15
784,New Zealand,1996,3,2,1,6
785,South Africa,1996,3,1,1,5
786,Ireland,1996,3,0,1,4
787,Sweden,1996,2,4,2,8
788,Norway,1996,2,2,3,7
789,Belgium,1996,2,2,2,6
790,Nigeria,1996,2,1,3,6
791,North Korea,1996,2,1,2,5
792,Algeria,1996,2,0,1,3
793,Ethiopia,1996,2,0,1,3
794,Great Britain,1996,1,8,6,15
795,Belarus,1996,1,6,8,15
796,Kenya,1996,1,4,3,8
797,Jamaica,1996,1,3,2,6
798,Finland,1996,1,2,1,4
799,FR Yugoslavia,1996,1,1,2,4
800,Indonesia,1996,1,1,2,4
801,Iran,1996,1,1,1,3
802,Slovakia,1996,1,1,1,3
803,Armenia,1996,1,1,0,2
804,Croatia,1996,1,1,0,2
805,Portugal,1996,1,0,1,2
806,Thailand,1996,1,0,1,2
807,Burundi,1996,1,0,0,1
808,Costa Rica,1996,1,0,0,1
809,Ecuador,1996,1,0,0,1
810,Hong Kong,1996,1,0,0,1
811,Syria,1996,1,0,0,1
812,Argentina,1996,0,2,1,3
813,Namibia,1996,0,2,0,2
814,Slovenia,1996,0,2,0,2
815,Austria,1996,0,1,2,3
816,Malaysia,1996,0,1,1,2
817,Moldova,1996,0,1,1,2
818,Uzbekistan,1996,0,1,1,2
819,Azerbaijan,1996,0,1,0,1
820,Bahamas,1996,0,1,0,1
821,Chinese Taipei,1996,0,1,0,1
822,Latvia,1996,0,1,0,1
823,Philippines,1996,0,1,0,1
824,Tonga,1996,0,1,0,1
825,Zambia,1996,0,1,0,1
826,Georgia,1996,0,0,2,2
827,Morocco,1996,0,0,2,2
828,Trinidad and Tobago,1996,0,0,2,2
829,India,1996,0,0,1,1
830,Israel,1996,0,0,1,1
831,Lithuania,1996,0,0,1,1
832,Mexico,1996,0,0,1,1
833,Mongolia,1996,0,0,1,1
834,Mozambique,1996,0,0,1,1
835,Puerto Rico,1996,0,0,1,1
836,Tunisia,1996,0,0,1,1
837,Uganda,1996,0,0,1,1
838,United States,2000,37,24,32,93
839,Russia,2000,32,28,29,89
840,China,2000,28,16,14,58
841,Australia,2000,16,25,17,58
842,Germany,2000,13,17,26,56
843,France,2000,13,14,11,38
844,Italy,2000,13,8,13,34
845,Netherlands,2000,12,9,4,25
846,Cuba,2000,11,11,7,29
847,Great Britain,2000,11,10,7,28
848,Romania,2000,11,6,9,26
849,South Korea,2000,8,10,10,28
850,Hungary,2000,8,6,3,17
851,Poland,2000,6,5,3,14
852,Japan,2000,5,8,5,18
853,Bulgaria,2000,5,6,2,13
854,Greece,2000,4,6,3,13
855,Sweden,2000,4,5,3,12
856,Norway,2000,4,3,3,10
857,Ethiopia,2000,4,1,3,8
858,Ukraine,2000,3,10,10,23
859,Kazakhstan,2000,3,4,0,7
860,Belarus,2000,3,3,11,17
861,Canada,2000,3,3,8,14
862,Spain,2000,3,3,5,11
863,Turkey,2000,3,0,2,5
864,Iran,2000,3,0,1,4
865,Czech Republic,2000,2,3,3,8
866,Kenya,2000,2,3,2,7
867,Denmark,2000,2,3,1,6
868,Finland,2000,2,1,1,4
869,Austria,2000,2,1,0,3
870,Lithuania,2000,2,0,3,5
871,Azerbaijan,2000,2,0,1,3
872,Bahamas,2000,2,0,1,3
873,Slovenia,2000,2,0,0,2
874,Switzerland,2000,1,6,2,9
875,Indonesia,2000,1,3,2,6
876,Slovakia,2000,1,3,1,5
877,Mexico,2000,1,2,3,6
878,Nigeria,2000,1,2,0,3
879,Algeria,2000,1,1,3,5
880,Uzbekistan,2000,1,1,2,4
881,FR Yugoslavia,2000,1,1,1,3
882,Latvia,2000,1,1,1,3
883,New Zealand,2000,1,0,3,4
884,Estonia,2000,1,0,2,3
885,Thailand,2000,1,0,2,3
886,Croatia,2000,1,0,1,2
887,Cameroon,2000,1,0,0,1
888,Colombia,2000,1,0,0,1
889,Mozambique,2000,1,0,0,1
890,Brazil,2000,0,6,6,12
891,Jamaica,2000,0,6,3,9
892,Belgium,2000,0,2,3,5
893,South Africa,2000,0,2,3,5
894,Argentina,2000,0,2,2,4
895,Chinese Taipei,2000,0,1,4,5
896,Morocco,2000,0,1,4,5
897,North Korea,2000,0,1,3,4
898,Moldova,2000,0,1,1,2
899,Saudi Arabia,2000,0,1,1,2
900,Trinidad and Tobago,2000,0,1,1,2
901,Ireland,2000,0,1,0,1
902,Sri Lanka,2000,0,1,0,1
903,Uruguay,2000,0,1,0,1
904,Vietnam,2000,0,1,0,1
905,Georgia,2000,0,0,6,6
906,Costa Rica,2000,0,0,2,2
907,Portugal,2000,0,0,2,2
908,Armenia,2000,0,0,1,1
909,Barbados,2000,0,0,1,1
910,Chile,2000,0,0,1,1
911,Iceland,2000,0,0,1,1
912,India,2000,0,0,1,1
913,Israel,2000,0,0,1,1
914,Kuwait,2000,0,0,1,1
915,Kyrgyzstan,2000,0,0,1,1
916,Macedonia,2000,0,0,1,1
917,Qatar,2000,0,0,1,1
918,United States,2004,36,39,26,101
919,China,2004,32,17,14,63
920,Russia,2004,28,26,36,90
921,Australia,2004,17,16,17,50
922,Japan,2004,16,9,12,37
923,Germany,2004,13,16,20,49
924,France,2004,11,9,13,33
925,Italy,2004,10,11,11,32
926,South Korea,2004,9,12,9,30
927,Great Britain,2004,9,9,12,30
928,Cuba,2004,9,7,11,27
929,Hungary,2004,8,6,3,17
930,Ukraine,2004,8,5,9,22
931,Romania,2004,8,5,6,19
932,Greece,2004,6,6,4,16
933,Brazil,2004,5,2,3,10
934,Norway,2004,5,0,1,6
935,Netherlands,2004,4,9,9,22
936,Sweden,2004,4,2,1,7
937,Spain,2004,3,11,6,20
938,Canada,2004,3,6,3,12
939,Turkey,2004,3,3,4,10
940,Poland,2004,3,2,5,10
941,New Zealand,2004,3,2,0,5
942,Thailand,2004,3,1,4,8
943,Belarus,2004,2,5,6,13
944,Austria,2004,2,4,1,7
945,Ethiopia,2004,2,3,2,7
946,Iran,2004,2,2,2,6
947,Slovakia,2004,2,2,2,6
948,Chinese Taipei,2004,2,2,1,5
949,Georgia,2004,2,2,0,4
950,Bulgaria,2004,2,1,9,12
951,Denmark,2004,2,1,5,8
952,Jamaica,2004,2,1,2,5
953,Uzbekistan,2004,2,1,2,5
954,Morocco,2004,2,1,0,3
955,Argentina,2004,2,0,4,6
956,Chile,2004,2,0,1,3
957,Kazakhstan,2004,1,4,3,8
958,Kenya,2004,1,4,2,7
959,Czech Republic,2004,1,3,5,9
960,South Africa,2004,1,3,2,6
961,Croatia,2004,1,2,2,5
962,Lithuania,2004,1,2,0,3
963,Egypt,2004,1,1,3,5
964,Switzerland,2004,1,1,3,5
965,Indonesia,2004,1,1,2,4
966,Zimbabwe,2004,1,1,1,3
967,Azerbaijan,2004,1,0,4,5
968,Belgium,2004,1,0,2,3
969,Bahamas,2004,1,0,1,2
970,Israel,2004,1,0,1,2
971,Cameroon,2004,1,0,0,1
972,Dominican Republic,2004,1,0,0,1
973,United Arab Emirates,2004,1,0,0,1
974,North Korea,2004,0,4,1,5
975,Latvia,2004,0,4,0,4
976,Mexico,2004,0,3,1,4
977,Portugal,2004,0,2,1,3
978,Finland,2004,0,2,0,2
979,Serbia and Montenegro,2004,0,2,0,2
980,Slovenia,2004,0,1,3,4
981,Estonia,2004,0,1,2,3
982,Hong Kong,2004,0,1,0,1
983,India,2004,0,1,0,1
984,Paraguay,2004,0,1,0,1
985,Colombia,2004,0,0,2,2
986,Nigeria,2004,0,0,2,2
987,Venezuela,2004,0,0,2,2
988,Eritrea,2004,0,0,1,1
989,Mongolia,2004,0,0,1,1
990,Syria,2004,0,0,1,1
991,Trinidad and Tobago,2004,0,0,1,1
992,China,2008,48,22,30,100
993,United States,2008,36,39,37,112
994,Russia,2008,24,13,23,60
995,Great Britain,2008,19,13,19,51
996,Germany,2008,16,11,14,41
997,Australia,2008,14,15,17,46
998,South Korea,2008,13,11,8,32
999,Japan,2008,9,8,8,25
1000,Italy,2008,8,9,10,27
1001,France,2008,7,16,20,43
1002,Netherlands,2008,7,5,4,16
1003,Ukraine,2008,7,4,11,22
1004,Kenya,2008,6,4,6,16
1005,Spain,2008,5,11,3,19
1006,Jamaica,2008,5,4,2,11
1007,Poland,2008,4,5,2,11
1008,Ethiopia,2008,4,2,1,7
1009,Romania,2008,4,1,4,9
1010,Cuba,2008,3,10,17,30
1011,Canada,2008,3,9,8,20
1012,Hungary,2008,3,5,2,10
1013,Norway,2008,3,5,1,9
1014,Brazil,2008,3,4,10,17
1015,Belarus,2008,3,4,7,14
1016,Czech Republic,2008,3,3,1,7
1017,Slovakia,2008,3,3,0,6
1018,New Zealand,2008,3,2,4,9
1019,Georgia,2008,3,2,2,7
1020,Kazakhstan,2008,2,3,4,9
1021,Denmark,2008,2,2,3,7
1022,North Korea,2008,2,2,2,6
1023,Thailand,2008,2,2,2,6
1024,Mongolia,2008,2,2,0,4
1025,Switzerland,2008,2,1,4,7
1026,Argentina,2008,2,0,4,6
1027,Mexico,2008,2,0,2,4
1028,Belgium,2008,2,0,0,2
1029,Zimbabwe,2008,1,3,0,4
1030,Slovenia,2008,1,2,2,5
1031,Azerbaijan,2008,1,1,4,6
1032,Indonesia,2008,1,1,4,6
1033,Bulgaria,2008,1,1,3,5
1034,Turkey,2008,1,1,3,5
1035,Chinese Taipei,2008,1,1,2,4
1036,Finland,2008,1,1,2,4
1037,Latvia,2008,1,1,1,3
1038,Dominican Republic,2008,1,1,0,2
1039,Estonia,2008,1,1,0,2
1040,Portugal,2008,1,1,0,2
1041,Trinidad and Tobago,2008,1,1,0,2
1042,India,2008,1,0,2,3
1043,Iran,2008,1,0,1,2
1044,Cameroon,2008,1,0,0,1
1045,Panama,2008,1,0,0,1
1046,Tunisia,2008,1,0,0,1
1047,Sweden,2008,0,4,1,5
1048,Lithuania,2008,0,3,2,5
1049,Nigeria,2008,0,3,2,5
1050,Croatia,2008,0,2,3,5
1051,Colombia,2008,0,2,1,3
1052,Greece,2008,0,2,1,3
1053,Armenia,2008,0,1,4,5
1054,Uzbekistan,2008,0,1,3,4
1055,Austria,2008,0,1,2,3
1056,Ireland,2008,0,1,2,3
1057,Kyrgyzstan,2008,0,1,2,3
1058,Serbia,2008,0,1,2,3
1059,Algeria,2008,0,1,1,2
1060,Bahamas,2008,0,1,1,2
1061,Morocco,2008,0,1,1,2
1062,Tajikistan,2008,0,1,1,2
1063,Chile,2008,0,1,0,1
1064,Ecuador,2008,0,1,0,1
1065,Iceland,2008,0,1,0,1
1066,Malaysia,2008,0,1,0,1
1067,Samoa,2008,0,1,0,1
1068,Singapore,2008,0,1,0,1
1069,South Africa,2008,0,1,0,1
1070,Sudan,2008,0,1,0,1
1071,Vietnam,2008,0,1,0,1
1072,Egypt,2008,0,0,2,2
1073,Afghanistan,2008,0,0,1,1
1074,Israel,2008,0,0,1,1
1075,Mauritius,2008,0,0,1,1
1076,Moldova,2008,0,0,1,1
1077,Togo,2008,0,0,1,1
1078,Venezuela,2008,0,0,1,1
1079,United States,2012,48,26,30,104
1080,China,2012,39,31,22,92
1081,Great Britain,2012,29,18,18,65
1082,Russia,2012,18,21,26,65
1083,South Korea,2012,13,9,9,31
1084,Germany,2012,11,20,13,44
1085,France,2012,11,11,13,35
1086,Australia,2012,8,15,12,35
1087,Italy,2012,8,9,11,28
1088,Hungary,2012,8,4,6,18
1089,Japan,2012,7,14,17,38
1090,Iran,2012,7,5,1,13
1091,Netherlands,2012,6,6,8,20
1092,New Zealand,2012,6,2,5,13
1093,Ukraine,2012,5,4,10,19
1094,Cuba,2012,5,3,7,15
1095,Spain,2012,4,10,6,20
1096,Jamaica,2012,4,5,4,13
1097,Czech Republic,2012,4,4,3,11
1098,South Africa,2012,4,1,1,6
1099,North Korea,2012,4,0,2,6
1100,Brazil,2012,3,5,9,17
1101,Kazakhstan,2012,3,2,6,11
1102,Poland,2012,3,2,6,11
1103,Ethiopia,2012,3,2,3,8
1104,Croatia,2012,3,1,2,6
1105,Canada,2012,2,6,10,18
1106,Belarus,2012,2,5,3,10
1107,Kenya,2012,2,4,7,13
1108,Denmark,2012,2,4,3,9
1109,Romania,2012,2,4,1,7
1110,Azerbaijan,2012,2,2,5,9
1111,Switzerland,2012,2,2,0,4
1112,Norway,2012,2,1,1,4
1113,Lithuania,2012,2,0,3,5
1114,Tunisia,2012,2,0,1,3
1115,Sweden,2012,1,4,3,8
1116,Colombia,2012,1,3,5,9
1117,Mexico,2012,1,3,4,8
1118,Georgia,2012,1,2,3,6
1119,Ireland,2012,1,1,4,6
1120,Argentina,2012,1,1,2,4
1121,Serbia,2012,1,1,2,4
1122,Slovenia,2012,1,1,2,4
1123,Trinidad and Tobago,2012,1,1,2,4
1124,Turkey,2012,1,1,1,3
1125,Dominican Republic,2012,1,1,0,2
1126,Chinese Taipei,2012,1,0,1,2
1127,Latvia,2012,1,0,1,2
1128,Algeria,2012,1,0,0,1
1129,Bahamas,2012,1,0,0,1
1130,Bahrain,2012,1,0,0,1
1131,Grenada,2012,1,0,0,1
1132,Uganda,2012,1,0,0,1
1133,Venezuela,2012,1,0,0,1
1134,Egypt,2012,0,3,1,4
1135,India,2012,0,2,4,6
1136,Mongolia,2012,0,2,3,5
1137,Thailand,2012,0,2,2,4
1138,Bulgaria,2012,0,2,1,3
1139,Finland,2012,0,2,1,3
1140,Indonesia,2012,0,2,1,3
1141,Slovakia,2012,0,1,3,4
1142,Belgium,2012,0,1,2,3
1143,Armenia,2012,0,1,1,2
1144,Estonia,2012,0,1,1,2
1145,Malaysia,2012,0,1,1,2
1146,Puerto Rico,2012,0,1,1,2
1147,Qatar,2012,0,1,1,2
1148,Botswana,2012,0,1,0,1
1149,Cyprus,2012,0,1,0,1
1150,Gabon,2012,0,1,0,1
1151,Guatemala,2012,0,1,0,1
1152,Montenegro,2012,0,1,0,1
1153,Portugal,2012,0,1,0,1
1154,Uzbekistan,2012,0,0,3,3
1155,Greece,2012,0,0,2,2
1156,Singapore,2012,0,0,2,2
1157,Afghanistan,2012,0,0,1,1
1158,Cameroon,2012,0,0,1,1
1159,Hong Kong,2012,0,0,1,1
1160,Kuwait,2012,0,0,1,1
1161,Morocco,2012,0,0,1,1
1162,Saudi Arabia,2012,0,0,1,1
1163,Tajikistan,2012,0,0,1,1
1164,Vietnam,2012,0,0,1,1
1165,United States,2016,46,37,38,121
1166,Great Britain,2016,27,23,17,67
1167,China,2016,26,18,26,70
1168,Russia,2016,19,17,20,56
1169,Germany,2016,17,10,15,42
1170,Japan,2016,12,8,21,41
1171,France,2016,10,18,14,42
1172,South Korea,2016,9,3,9,21
1173,Italy,2016,8,12,8,28
1174,Australia,2016,8,11,10,29
1175,Netherlands,2016,8,7,4,19
1176,Hungary,2016,8,3,4,15
1177,Brazil,2016,7,6,6,19
1178,Spain,2016,7,4,6,17
1179,Kenya,2016,6,6,1,13
1180,Jamaica,2016,6,3,2,11
1181,Croatia,2016,5,3,2,10
1182,Cuba,2016,5,2,4,11
1183,New Zealand,2016,4,9,5,18
1184,Canada,2016,4,3,15,22
1185,Uzbekistan,2016,4,2,7,13
1186,Colombia,2016,3,2,3,8
1187,Switzerland,2016,3,2,2,7
1188,Iran,2016,3,1,4,8
1189,Greece,2016,3,1,2,6
1190,Argentina,2016,3,1,0,4
1191,Denmark,2016,2,6,7,15
1192,Sweden,2016,2,6,3,11
1193,South Africa,2016,2,6,2,10
1194,Kazakhstan,2016,2,5,10,17
1195,Ukraine,2016,2,5,4,11
1196,Serbia,2016,2,4,2,8
1197,Poland,2016,2,3,6,11
1198,North Korea,2016,2,3,2,7
1199,Belgium,2016,2,2,2,6
1200,Thailand,2016,2,2,2,6
1201,Slovakia,2016,2,2,0,4
1202,Georgia,2016,2,1,4,7
1203,Azerbaijan,2016,1,7,10,18
1204,Belarus,2016,1,4,4,9
1205,Turkey,2016,1,3,4,8
1206,Armenia,2016,1,3,0,4
1207,Czech Republic,2016,1,2,7,10
1208,Ethiopia,2016,1,2,5,8
1209,Slovenia,2016,1,2,1,4
1210,Indonesia,2016,1,2,0,3
1211,Romania,2016,1,1,2,4
1212,Bahrain,2016,1,1,0,2
1213,Vietnam,2016,1,1,0,2
1214,Chinese Taipei,2016,1,0,2,3
1215,Bahamas,2016,1,0,1,2
1216,Independent Olympic Athletes,2016,1,0,1,2
1217,Ivory Coast,2016,1,0,1,2
1218,Fiji,2016,1,0,0,1
1219,Jordan,2016,1,0,0,1
1220,Kosovo,2016,1,0,0,1
1221,Puerto Rico,2016,1,0,0,1
1222,Singapore,2016,1,0,0,1
1223,Tajikistan,2016,1,0,0,1
1224,Malaysia,2016,0,4,1,5
1225,Mexico,2016,0,3,2,5
1226,Venezuela,2016,0,2,1,3
1227,Algeria,2016,0,2,0,2
1228,Ireland,2016,0,2,0,2
1229,Lithuania,2016,0,1,3,4
1230,Bulgaria,2016,0,1,2,3
1231,India,2016,0,1,1,2
1232,Mongolia,2016,0,1,1,2
1233,Burundi,2016,0,1,0,1
1234,Grenada,2016,0,1,0,1
1235,Niger,2016,0,1,0,1
1236,Philippines,2016,0,1,0,1
1237,Qatar,2016,0,1,0,1
1238,Norway,2016,0,0,4,4
1239,Egypt,2016,0,0,3,3
1240,Tunisia,2016,0,0,3,3
1241,Israel,2016,0,0,2,2
1242,Austria,2016,0,0,1,1
1243,Dominican Republic,2016,0,0,1,1
1244,Estonia,2016,0,0,1,1
1245,Finland,2016,0,0,1,1
1246,Morocco,2016,0,0,1,1
1247,Nigeria,2016,0,0,1,1
1248,Portugal,2016,0,0,1,1
1249,Trinidad and Tobago,2016,0,0,1,1
1250,United Arab Emirates,2016,0,0,1,1
1251,United States,2020,39,41,33,113
1252,China,2020,38,32,19,89
1253,Japan,2020,27,14,17,58
1254,Great Britain,2020,22,20,22,64
1255,ROC,2020,20,28,23,71
1256,Australia,2020,17,7,22,46
1257,Netherlands,2020,10,12,14,36
1258,France,2020,10,12,11,33
1259,Germany,2020,10,11,16,37
1260,Italy,2020,10,10,20,40
1261,Canada,2020,7,7,10,24
1262,Brazil,2020,7,6,8,21
1263,New Zealand,2020,7,6,7,20
1264,Cuba,2020,7,3,5,15
1265,Hungary,2020,6,7,7,20
1266,South Korea,2020,6,4,10,20
1267,Poland,2020,4,5,5,14
1268,Czech Republic,2020,4,4,3,11
1269,Kenya,2020,4,4,2,10
1270,Norway,2020,4,2,2,8
1271,Jamaica,2020,4,1,4,9
1272,Spain,2020,3,8,6,17
1273,Sweden,2020,3,6,0,9
1274,Switzerland,2020,3,4,6,13
1275,Denmark,2020,3,4,4,11
1276,Croatia,2020,3,3,2,8
1277,Iran,2020,3,2,2,7
1278,Serbia,2020,3,1,5,9
1279,Belgium,2020,3,1,3,7
1280,Bulgaria,2020,3,1,2,6
1281,Slovenia,2020,3,1,1,5
1282,Uzbekistan,2020,3,0,2,5
1283,Georgia,2020,2,5,1,8
1284,Chinese Taipei,2020,2,4,6,12
1285,Turkey,2020,2,2,9,13
1286,Greece,2020,2,1,1,4
1287,Uganda,2020,2,1,1,4
1288,Ecuador,2020,2,1,0,3
1289,Ireland,2020,2,0,2,4
1290,Israel,2020,2,0,2,4
1291,Qatar,2020,2,0,1,3
1292,Bahamas,2020,2,0,0,2
1293,Kosovo,2020,2,0,0,2
1294,Ukraine,2020,1,6,12,19
1295,Belarus,2020,1,3,3,7
1296,Romania,2020,1,3,0,4
1297,Venezuela,2020,1,3,0,4
1298,India,2020,1,2,4,7
1299,Hong Kong,2020,1,2,3,6
1300,Philippines,2020,1,2,1,4
1301,Slovakia,2020,1,2,1,4
1302,South Africa,2020,1,2,0,3
1303,Austria,2020,1,1,5,7
1304,Egypt,2020,1,1,4,6
1305,Indonesia,2020,1,1,3,5
1306,Ethiopia,2020,1,1,2,4
1307,Portugal,2020,1,1,2,4
1308,Tunisia,2020,1,1,0,2
1309,Estonia,2020,1,0,1,2
1310,Fiji,2020,1,0,1,2
1311,Latvia,2020,1,0,1,2
1312,Thailand,2020,1,0,1,2
1313,Bermuda,2020,1,0,0,1
1314,Morocco,2020,1,0,0,1
1315,Puerto Rico,2020,1,0,0,1
1316,Colombia,2020,0,4,1,5
1317,Azerbaijan,2020,0,3,4,7
1318,Dominican Republic,2020,0,3,2,5
1319,Armenia,2020,0,2,2,4
1320,Kyrgyzstan,2020,0,2,1,3
1321,Mongolia,2020,0,1,3,4
1322,Argentina,2020,0,1,2,3
1323,San Marino,2020,0,1,2,3
1324,Jordan,2020,0,1,1,2
1325,Malaysia,2020,0,1,1,2
1326,Nigeria,2020,0,1,1,2
1327,Bahrain,2020,0,1,0,1
1328,Lithuania,2020,0,1,0,1
1329,Namibia,2020,0,1,0,1
1330,North Macedonia,2020,0,1,0,1
1331,Saudi Arabia,2020,0,1,0,1
1332,Turkmenistan,2020,0,1,0,1
1333,Kazakhstan,2020,0,0,8,8
1334,Mexico,2020,0,0,4,4
1335,Finland,2020,0,0,2,2
1336,Botswana,2020,0,0,1,1
1337,Burkina Faso,2020,0,0,1,1
1338,Ghana,2020,0,0,1,1
1339,Grenada,2020,0,0,1,1
1340,Ivory Coast,2020,0,0,1,1
1341,Kuwait,2020,0,0,1,1
1342,Moldova,2020,0,0,1,1
1343,Syria,2020,0,0,1,1
1344,United States,2024,40,44,42,126
1345,China,2024,40,27,24,91
1346,Japan,2024,20,12,13,45
1347,Australia,2024,18,19,16,53
1348,France,2024,16,26,22,64
1349,Netherlands,2024,15,7,12,34
1350,Great Britain,2024,14,22,29,65
1351,South Korea,2024,13,9,10,32
1352,Italy,2024,12,13,15,40
1353,Germany,2024,12,13,8,33
1354,New Zealand,2024,10,7,3,20
1355,Canada,2024,9,7,11,27
1356,Uzbekistan,2024,8,2,3,13
1357,Hungary,2024,6,7,6,19
1358,Spain,2024,5,4,9,18
1359,Sweden,2024,4,4,3,11
1360,Kenya,2024,4,2,5,11
1361,Norway,2024,4,1,3,8
1362,Ireland,2024,4,0,3,7
1363,Brazil,2024,3,7,10,20
1364,Iran,2024,3,6,3,12
1365,Ukraine,2024,3,5,4,12
1366,Romania,2024,3,4,2,9
1367,Georgia,2024,3,3,1,7
1368,Belgium,2024,3,1,6,10
1369,Bulgaria,2024,3,1,3,7
1370,Serbia,2024,3,1,1,5
1371,Czech Republic,2024,3,0,2,5
1372,Denmark,2024,2,2,5,9
1373,Azerbaijan,2024,2,2,3,7
1374,Croatia,2024,2,2,3,7
1375,Cuba,2024,2,1,6,9
1376,Bahrain,2024,2,1,1,4
1377,Slovenia,2024,2,1,0,3
1378,Chinese Taipei,2024,2,0,5,7
1379,Austria,2024,2,0,3,5
1380,Hong Kong,2024,2,0,2,4
1381,Philippines,2024,2,0,2,4
1382,Algeria,2024,2,0,1,3
1383,Indonesia,2024,2,0,1,3
1384,Israel,2024,1,5,1,7
1385,Poland,2024,1,4,5,10
1386,Kazakhstan,2024,1,3,3,7
1387,Jamaica,2024,1,3,2,6
1388,South Africa,2024,1,3,2,6
1389,Thailand,2024,1,3,2,6
1390,Individual Neutral Athletes,2024,1,3,1,5
1391,Ethiopia,2024,1,3,0,4
1392,Switzerland,2024,1,2,5,8
1393,Ecuador,2024,1,2,2,5
1394,Portugal,2024,1,2,1,4
1395,Greece,2024,1,1,6,8
1396,Argentina,2024,1,1,1,3
1397,Egypt,2024,1,1,1,3
1398,Tunisia,2024,1,1,1,3
1399,Botswana,2024,1,1,0,2
1400,Chile,2024,1,1,0,2
1401,Saint Lucia,2024,1,1,0,2
1402,Uganda,2024,1,1,0,2
1403,Dominican Republic,2024,1,0,2,3
1404,Guatemala,2024,1,0,1,2
1405,Morocco,2024,1,0,1,2
1406,Dominica,2024,1,0,0,1
1407,Pakistan,2024,1,0,0,1
1408,Turkey,2024,0,3,5,8
1409,Mexico,2024,0,3,2,5
1410,Armenia,2024,0,3,1,4
1411,Colombia,2024,0,3,1,4
1412,Kyrgyzstan,2024,0,2,4,6
1413,North Korea,2024,0,2,4,6
1414,Lithuania,2024,0,2,2,4
1415,India,2024,0,1,5,6
1416,Moldova,2024,0,1,3,4
1417,Kosovo,2024,0,1,1,2
1418,Cyprus,2024,0,1,0,1
1419,Fiji,2024,0,1,0,1
1420,Jordan,2024,0,1,0,1
1421,Mongolia,2024,0,1,0,1
1422,Panama,2024,0,1,0,1
1423,Tajikistan,2024,0,0,3,3
1424,Albania,2024,0,0,2,2
1425,Grenada,2024,0,0,2,2
1426,Malaysia,2024,0,0,2,2
1427,Puerto Rico,2024,0,0,2,2
1428,Cape Verde,2024,0,0,1,1
1429,Ivory Coast,2024,0,0,1,1
1430,Peru,2024,0,0,1,1
1431,Qatar,2024,0,0,1,1
1432,Refugee Olympic Team,2024,0,0,1,1
1433,Singapore,2024,0,0,1,1
1434,Slovakia,2024,0,0,1,1
1435,Zambia,2024,0,0,1,1
